NO ./textures/brother.xpm
SO ./textures/brother.xpm
WE ./textures/brother.xpm
EA ./textures/brother.xpm

F 240,240,240
C 0,191,255

111111111

111111111
100000001
100N01111
100001
111111
