NO ./textures/cavern.xpm
SO ./textures/cavern.xpm
WE ./textures/cavern.xpm
EA ./textures/cavern.xpm

F 125,135,160
C 60,67,86

1111111111111111111111111111111
1111110000000000000011100000111
1000000000011110000011000001111
1111110000100000100000000000001
1000010000111000100011111111111
11100100000000010N0000000000001
1000000000000001000110111000001
1110000000000000001000110000001
1111000010001000001111000000011
1000000011111000000000100111111
1001000000100000000000000111111
1001000000100010000000000000001
1111100000100010000000000001111
1000000000111110000000000000001
1000000000000000000100001101111
1110000011111111000000000100001
1111111111111111111111111111111
