NO ./textures/colored_bricks.xpm
SO ./textures/colored_bricks.xpm
WE ./textures/colored_bricks.xpm
EA ./textures/colored_bricks.xpm

F 155,118,83
C 0,191,255

1111111111111111
1000000000000001
1000001111000001
1000001000001001
1000001000010001
100000100010N001
1000111000000001
1000000000000001
1000000000000001
1000000000000001
1111111111111111
