NO ./textures/white_bricks.xpm
SO ./textures/grey_bricks.xpm
WE ./textures/blue_bricks.xpm
EA ./textures/black_bricks.xpm

F 47,79,79
C 34,45,90

1111111111111111
1E00000000000001
1001111111110001
1000001000000001
1011111110111111
1000001000000001
1000111110000001
1000100011111001
1000100000000001
101111001000111111111111111111
100001001000100000000010000001
110111001000111110000011111101
100001001000000000000010000001
101101111011111111111111111101
100000000000000000000000000001
111111111111111111111111111111