NO ./textures/wood_wall.xpm
SO ./textures/wood_wall.xpm
WE ./textures/wood_wall.xpm
EA ./textures/wood_wall.xpm

F 113,169,44
C 0,191,255

    1111111111111111
11111100000000000000111111
100000000001111000000000001111
1111100000100000100000000000001
    10000111000100011111111111
    100000000010N001
    1000110111000001
    10001000110000001
1111000010001000001111
10000000111110000000001
10010000001000000000001
1001000000100010000000011
11111000001000100000000001
    10000011111000000000001
    1000000000100001111111
    1000000000100001
    1111111111111111
